MOG	General Oligodendrocyte
MOBP	General Oligodendrocyte
MBP	General Oligodendrocyte
PALM2	Oligodendrocyte_MatureRest_Agarwal
LGALS1	Oligodendrocyte_MatureProtective_Agarwal
PPM1G	Oligodendrocyte_MatureMyelin_Agarwal
TH	Oligodendrocyte_Dopamine_Martirosyan
SLC6A3	Oligodendrocyte_Dopamine_Martirosyan
SNCG	Oligodendrocyte_Dopamine_Martirosyan
UCHL1	Oligodendrocyte_Dopamine_AxonDevelopmentSynpaseOrganization_Martirosyan
NEFL	Oligodendrocyte_Dopamine_AxonDevelopmentSynpaseOrganization_Martirosyan
MAP1B	Oligodendrocyte_Dopamine_AxonDevelopmentSynpaseOrganization_Martirosyan
NRXN3	Oligodendrocyte_Dopamine_AxonDevelopmentSynpaseOrganization_Martirosyan
CNTN1	Oligodendrocyte_Dopamine_IonTransport_Martirosyan
ANK3	Oligodendrocyte_Dopamine_IonTransport_Martirosyan
SLC18A2	Oligodendrocyte_Dopamine_SynapticVesicleCycle_Martirosyan
CALY	Oligodendrocyte_Dopamine_SynapticVesicleCycle_Martirosyan
CRYAB	Oligodendrocyte_OxiStressProteinAggregation_Martirosyan
FTL	Oligodendrocyte_OxiStressProteinAggregation_IronStorage_Martirosyan
FTH1	Oligodendrocyte_OxiStressProteinAggregation_IronStorage_Martirosyan
S100B	Oligodendrocyte_OxiStressProteinAggregation_GlialStress_Martirosyan
RBFOX1	Oligodendrocyte_NeurodevelopmentSynaptic_Martirosyan
OPALIN	Oligodendrocyte_MyelinatingODC_Martirosyan